12
1,5,7,5,7,7,7,7,5,5,5,6
3,5,13,6,10,10,10,10,3,5,5,14
11,5,5,12,10,10,10,10,9,5,5,14
11,5,5,6,10,10,10,10,3,5,5,14
11,5,5,12,9,13,13,12,9,5,5,14
11,5,5,6,2,3,6,2,3,5,5,14
11,5,5,12,10,9,14,10,9,5,5,14
11,5,5,6,11,5,13,14,3,5,5,14
11,5,5,12,10,2,2,10,9,5,5,14
11,5,5,6,10,10,10,10,3,5,5,14
11,5,5,12,10,10,10,10,9,5,5,14
9,5,5,5,13,13,13,13,5,5,5,12